User	Track	URL
May27	Astrud Gilberto - The Girl From Ipanema	
poplavor, Zekk	Zekk & poplavor - Gloomy Flash (feat. mami)	
Duran Duran	INVISIBLE	
flightless	Work This Time	
breathe in unison with me	–Ω–µ—Ä–≤—ã - –Ω–µ—Ä–≤—ã	
Retrynth	M.O.O.N. - Dust	
Modikas.	Boulevard Depo - Ocb (sp4k Remix)	
Porter Robinson	Hollowheart ft. Amy Millan (From the Worlds 10th Anniversary Edition)	
Enya	Only Time	
Enya	Orinoco Flow (2009 Remaster)	
Goldie Boutilier	Sex Parano√Øa	
ROMANTICA	ROMANTICA, Lestmor - EASY PEAZY	
‚òÜ meouch ‚òÜ	ùëªùíâùíìùíÜùíÜ ùë´ùíÇùíöùíî ùëÆùíìùíÇùíÑùíÜ - ùî∏ùïüùïöùïûùïíùïù ùïÄ ùïôùïíùïßùïñ ùïìùïñùïîùï†ùïûùïñ (ùê¨ùê•ùê®ùê∞ùêûùêù)	
NXCRE	NXCRE & The Villains - INDIGO	
notamaincharacter	we are the people - empire of the sun(sped up+reverb)	
SIDEWALKS AND SKELETONS	Underwater Sun	
d o r m a n t  m i n d	crystal castles - char (slowed + reverb)	
Sidewalks and Skeletons	EXORCISM [NEW ALBUM OUT NOW!!]	
soft siren	4am	
bbragui	In Heaven Together	
donovan	Final Wish - ooxygen	
Boards of Canada	Dawn Chorus	
Ringo Deathstarr	Gazin'	
nattguld	Sidewalks And Skeletons White Light	
Disfigure	Disfigure - Blank [NCS Release]	
Lykke Li	I Follow Rivers	
Crystal Cola	HARUKO	
Rosentwig	On My Way	
Crystal Cola	Orion	
A.L.I.S.O.N	Take Off!	
Crystal Cola	Seaside Cocktail	
FindMyName	Buba	
Rosentwig, A.L.I.S.O.N	A.L.I.S.O.N & Rosentwig - Short Circuit	
Hiko Momoji, Nova, Nosgov	Whole Ride (Feat. Nosgov) - Nova x Hiko	
Rory in early 20s	utsukushi yume no yume	
Iwakura	Iwakura -	
usedcvnt	you're my friend now (w/ DXRKWRLD)	
usedcvnt	limited in love (w/ AKIBA)	
wiv	e e e e	
Chief Bubba	Serial Experiments Lain - Cyberia Theme	
23arms	lain	
FM Attack	Magic (feat. Kristine)	
plenka	–ö–æ–ª–µ—è	
leruan.marlen	Palina - –î—ë–≥–æ—Ç—å	
Knerv	Knerv - Don't Count	
–ü–∞—à–∞ –¢–µ—Ö–Ω–∏–∫	–õ–û–®–û–ö ( LAPTI prod. )	
–ü–∞—à–∞ –¢–µ—Ö–Ω–∏–∫	–°–ü–ê–°–ê–ï–¢ –ü–ê–†–ê–ù–û–Ø ( CLICK MONSTAH prod. )	
–ü–∞—à–∞ –¢–µ—Ö–Ω–∏–∫	–ê—Ö—É–µ–Ω–Ω–æ –ö–æ–≥–æ-–ù–∏–±—É–¥—å –£–±–∏—Ç—å ( feat. The Chemodan Clan )	
SpaceCave	15) –ü–æ—ë—Ç–µ –¢–∞–∫ –°–µ–±–µ v.2.0 (–ø—Ä–∏ —É—á. –ü–∞—à–∞ –¢–µ—Ö–Ω–∏–∫)	
–£–±–∏–π—Ü—ã	00–µ	
hanagasumi	‚úß —É–±–∏–π—Ü—ã - —Å–∞–º–æ–¥–∏–∞–≥–Ω–æ–∑—ã ‚úß	
Eliminate*	comecloser	
Eery	divine	
Panchiko	Stabilisers For Big Boys	
Panchiko	D>E>A>T>H>M>E>T>A>L	
BPA–ì	–ü–≠‚Ññ90 : –ê–ª-90	
–£–±–∏–π—Ü—ã	–°–µ–∫—Ä–µ—Ç–∞—Ä—à–∞	
–£–±–∏–π—Ü—ã	–î–∏–Ω–∞–º–æ	
Bill Kiley	Bill Kiley - V Limo (New Donk Shitty)	
Bill Kiley	Bill Kiley - Worst Neighbors Ever	
uncle pecos	–ì—Ä—É—Å—Ç—å	
K!LL	welcome 2 night city	
ryuk	accident prone *OUT ON SPOTIFY*	
‚Äé	Leave by Whirr lq + slowed	
Warren Grugett	Lobby Lounge Theme	
akiaura	akiaura, LONOWN, STM - Sleepwalker	
Purnell Media Solutions	Odetari X 9lives - I LOVE YOU HOE  (Purnell Media Solutions Collective Edition)	
sayUUU	Britney Manson - FASHION (SPEED UP)	
syko	#BROOKLYNBLOODPOP! (@ssyyko insta}	
Mac Levine	Sparks - Coldplay	
Cheech	GGW	
The Post Sips	A Fighting Chance	
mirax	–ü–æ—à–ª–∞—è –ú–æ–ª–ª–∏ - —Å–∞–º–∞—è –∫–ª—ë–≤–∞—è —Ç—ë–ª–∫–∞ –≤ —à–∫–æ–ª–µ	
‚òª  ‚òºÔ∏é‚úåÔ∏é‚úãÔ∏é‚ò†Ô∏é  ‚öêÔ∏é ‚ò†Ô∏é  üí£Ô∏é‚öêÔ∏é‚ò†Ô∏éüëéÔ∏é‚úåÔ∏é‚ú°Ô∏éüíßÔ∏é  ‚òª	Or You Will Nuke Possum Springs	
.angel	IVOXYGEN -Urban Melody	
regiibk	someday by the uchpochmack	
KoruSe, CHMCL SOUP	BLACKOUT	
iwanttobeehappy	vvalleys - scars (remix adli)	
5admin	5admin - Slime & Sword	
∆ä–Ñstroƒ™ƒê„ÉÖ	Mujuice ‚Äì Underground	
Yurii Vovk	Kunteiynir-–ö–∞—Å—Å–∏—Ä –≤–æ Fred Perry	
Kunteynir	18:45:54	
KUNTEYNIR / –†–ê–°–ö–û–õ–¨–ù–ò–ö–û–í	–í –ú–ê–†–®–†–£–¢–ö–ï –®–ê–ù–°–û–ù	
Emil Rottmayer	Evade ( Free Download )	
Lucy in Disguise	Southbound	
Herb the French	Emerge - Fischerspooner (Daft Punk mix)	
DEMON	DEMON - You Are My High (Vitalic Remix)	
omgpewpower	Kunteynir ‚Äì –û–ª—å–≥–∞ –ú–∞—Ä–∫–æ–≤–Ω–∞	
Lucas de Gastines	Dimanche Soir (feat. ACE)	
Dimitri Liparteliani	–ö–∏–Ω–æ - –ì—Ä—É–ø–ø–∞ –∫—Ä–æ–≤–∏	
Everything Gorillaz - P3	On Melancholy Hill	
KinoCoj	–°–ª–µ–¥–∏ –∑–∞ —Å–æ–±–æ–π	
KinoCoj	–ó–∞–∫—Ä–æ–π –∑–∞ –º–Ω–æ–π –¥–≤–µ—Ä—å, —è —É—Ö–æ–∂—É	
KinoCoj	–ê–ø—Ä–µ–ª—å	
KinoCoj	–ó–≤–µ–∑–¥–∞ –ø–æ –∏–º–µ–Ω–∏ –°–æ–ª–Ω—Ü–µ	
xxxtalll	The Hellp - Sinamen	
CorpseCycle	Tu Tu Neurotic (First Edition. Rare) By The Hellp	
–ò–≤–∞–Ω–æ–≤ –≠–¥–∏–∫	TIMURKA BITS - –î–ò–°–° –ù–ê –ö–û–ü–û–í	
Terrible Records	The Hellp - 4up7up	
The Hellp	The Hellp - feel NY	
xxxtalll	the hellp - hotfun 22 (demo)	
tomppabeats	Tomppabeats - tytt√∂ ep	
Greammy #	PORTWAVE - SHADOW LADY	
Juraj Baƒç√≠k	Linkin Park - Faint	
ADMO	Unwound (ft. andy shand)	
WEEDJIE(–í–∏–î–∂–∏)	WEEDJIE - SOS	
LovelySharkPlush	cold & lonely	
LovelySharkPlush	warmth	
nollman (√§t bajs)	C418 - Thunderbird	
Vlone	Kuznetsky Squad - –ó–∞–∫—Ä—ã—Ç—ã–π –ü—Ä–æ—Ñ–∏–ª—å	
Hi√©rophante	Timeline	
–ö–∏—Å–æ–∫–æ	–£–±–µ–π –º–µ–Ω—è –≠–π—Å - "LSD" daycore/slowed/down up	
Maximojaimes	Trance - 009 Sound System Dreamscape	
BONES	Windows95	
Prosmash	DIE ANTWOORD - BANANA BRAIN	
intighett	superkomfort ‚Äì –≤–∏—Ç–µ–±—Å–∫-—Ç–∞–ª–ª–∏–Ω	
‚óèùï∫ùñàùñàùñõùñëùñô-ùï±ùñîùñóùñäùñòùñô‚óè	–í–æ–ª–ª–Ω—ã - –í–æ–ª–Ω—ã	
ithelps	–í–æ–ª–ª–Ω—ã ‚Äì –¢–µ–±—è –Ω–µ—Ç —Ä—è–¥–æ–º	
RecLab	Something	
Ploho	Ploho - –ó–∞–∫–ª–∞–¥–∫–∞	
Ploho	Ploho - –í–µ—Ä–∞ –≤ –ø—Ä–µ–∫—Ä–∞—Å–Ω–æ–µ	
Ploho	04 - Ploho - –°—Ç—Ä–∞–Ω–∞ –î—É—Ä–∞–∫–æ–≤	
Ploho	05 - Ploho - –ú–æ–ª–æ–¥–æ—Å—Ç—å	
The Doors	Riders On The Storm	
Mazzy Star (Official)	Fade Into You	
Vivian	Sail - Mareux	
wpcwe	wpcwe - –ú–æ–π –¥—Ä—É–≥ –ø–æ–¥ –∫–∏—Å–ª–æ—Ç–æ–π	
PRIRODA	–î—ã—Ö–∞–Ω–∏–µ	
–®–´–®–ê	–ú–∞–≥–Ω–∏—Ç	
Cheech	InStyle	
Gazellefangs	My Existence Afterparty	
SOSKA 69	SOSKA 69 - –ë–ê–°–´ –î–û–õ–ë–Ø–¢	
KUNTEYNIR	KUNTEYNIR - –í –∞–∫–≤–∞–ø–∞—Ä–∫–µ	
–ú–∞–∫—Å –ö–æ—Ä–∂	–ï—ë –≤–∏–Ω–æ–π	
–ú–∞–∫—Å –ö–æ—Ä–∂	–ú–∞–∫—Å –ö–æ—Ä–∂ - –°—Ç–∏–ª–µ–≤–æ	
–ú–∞–∫—Å –ö–æ—Ä–∂	–°–æ–∂–∂–µ–Ω—ã	
–ú–∞–∫—Å –ö–æ—Ä–∂	–ì–æ—Ä—ã –ø–æ –∫–æ–ª–µ–Ω–æ	
Vezal, Reidenshi	√∏neheart x reidenshi - snowfall (slowed reverb)	
jon t	SCRIPTZ x JON T - PALE HORSE	
Pumawesome	I Heard You Like Polyrhythms	
Baby Jayy	Good Morning (PROD. Nikblor)	
big_bucks	Carpenter Brut - Le Perv (30% Slower)	
Carpenter Brut	Le Perv	
OMA	Rapp Snitch Knishes (Live Instrumental) (Cover)	
Vitalic Official	The Do - Slippery Slope (Vitalic Remix)	
Alter3030	Chikoi The Maid - Returnal	
Young Thug	Went Thru It	
zankoqqe	good loyal thots  ODETARI instrumental  slowed  louder	
Brado	Bag Raiders - Shooting Stars (Slowed)	
ANGEL CANNON	Ôº≥ Ôºπ ÔºÆ Ôº° Ôº∞ Ôº≥ Ôº•	
lil nikki ^^	ùî≠ùîûùî∞ùî±ùî¢ùî© ùî§ùî•ùî¨ùî∞ùî± - ùî¢ùî™ùîüùîØùîûùî†ùî¢ (ùî∞ùî©ùî¨ùî¥ùî¢ùî°)	
Tony_Síâ≠	Resonance x Genesis x Not Allowed (Slowed + Reverb)	
SymbolOne	NID&SANCY - M.U.S.I.C (SymbolOne Remix)	
Magna	Magna - Divide (Hotline Miami 2 : Wrong Number OST)	
Splattie	Variation of "Ode" (Frozen City B) - Nuclear Throne	
Roll20musicpls	Nuclear Throne OST- Frozen City Theme B Extended	
The Chordettes	Sh Boom Life Could Be a Dream	
Medoi The Maid	Medoi The Maid, Akui The Maid - Kittycuts	
eery	just one sec	
Eliminate*	thinkaboutit	
EL TIGR3	She Swallowed Burning Coals	
marc9132	L'AMOUR ET LA VIOLENCE (Boys Noize Euro mix)	
Fixions	Black Racers ( Mother Russia Bleeds soundtrack )	
The Flame	Muse - Plug in Baby Rearranged and Remastered	
Carol Olguin	Etienne De Crecy Featuring Camille - Someone Like You (Fast Track Vocal Mix)	
ORE / ERO	The Past -Vitalic (remix Par Or√©)	
Ruski	sidewalks and skeletons - goth [slowed]	
AVEGA	–ü–µ—Ä–µ–¥–∞–π (feat. –ü–∞—à–∞ –¢–µ—Ö–Ω–∏–∫ & –ì—Ä–∞–¥–∏)	
–•–ê–ù –ó–ê–ú–ê–ô & –°–õ–ê–í–ê –ö–ü–°–°	–í–µ–π–ø-–í–µ–π–ø-–í–µ–π–ø ft. –õ–°–ü, Young P&H, –≠–ü–ü, –ó–∞–µ–±–∞—Ç—Å—É, –ë—É–∫–µ—Ä –î. –§—Ä–µ–¥ (prvrln prod.)	
Juicewrldd4L_2	SPIT IN MY FACE!	
Deadcrow	Deadcrow - Scythe	
its.eddie	joji die for you but it's 2:23am	
Cinnamon Chasers	She Loves Only Him	
Eliminate*	SMSOU w/ Frost Children	
Eliminate*	EGOTRIP	
Bxtmxn	‚ô°~Always Forever// Cults -	
tom	Untitled #13 - Glwzbll (slowed)	
Eliminate*	Dawn w/ Flux Pavilion (Feat. meesh)	
Noize MC	–í—Å–µ–ª–µ–Ω–Ω–∞—è –±–µ—Å–∫–æ–Ω–µ—á–Ω–∞?	
–õ–°–ü	–ë–æ–ª—å—à–µ –¥–µ–Ω–µ–≥	
Cafun√©	Tek It	
Warren Grugett	Gameplay Theme 7	
Warren Grugett	Gameplay Theme 5	
Heimanu	I Watch The Moon	
FrankJavCee	SimpsonWave1995	
–ê–≤—Ç–æ—Å–ø–æ—Ä—Ç	–ü–æ–∂–∞–ª—É–π—Å—Ç–∞, —Ç–æ–ª—å–∫–æ –Ω–µ –¥–æ–º–æ–π	
lxnaya	CHERNOBURKV - POCHEMU	
633397	ash	
Feral	The Symposium - Fire Island & Billy Shakes	
Cinnamon Chasers	Luv Deluxe	
3BEAT	Sak Noel - Loca People (Explicit Radio Edit)	
zzzavani	–í–∏–∫—Ç–æ—Ä –¶–æ–π - –°–ø–æ–∫–æ–π–Ω–∞—è –Ω–æ—á—å (slowed + reverbed version) by zzzavani	
—É–ª–∏—Ü–∞ –≤–æ—Å—Ç–æ–∫	–£–ª–∏—Ü–∞ –í–æ—Å—Ç–æ–∫ - –°–Ω–æ–≤–∞ –ü—Ä–∏–≤–µ—Ç( feat. –ú–ê–†–ù–ò–ô)	
Modulogeek	around	
ùô∑ùöòùöõùöûùöîùöò_	wisp - your face (you look at me, the same, but I can't reciprocate)	
Ren | Mothie >:l	Slowed caramelldansen from another room	
Blank Banshee	Teen Pregnancy	
DJ –ü–ï–†–ï–ö–†–´–¢	–°–û–õ–¨ –ò –°–ü–û–†–¢	
lulub78	Dramarama- Anything, Anything	
VMacbeth	Paradise	
cluboviy	plenka - Symptoms	
–ñ–∞–Ω–Ω–∞ –ê–≥—É–∑–∞—Ä–æ–≤–∞ –∏ –ë—Ä–∞–≤–æ	–ë—Ä–∞–≤–æ & –ñ–∞–Ω–Ω–∞ –ê–≥—É–∑–∞—Ä–æ–≤–∞ - –í–µ—Ä—é —è	
Glorb	The Bottom 2	
mr.avsh	–î–µ–ª—å—Ñ–∏–Ω - –õ—é–±–æ–≤—å	
O__KLY ‚Ñ¢	Vitalic - Next I'm ready	
Medoi The Maid	Akumu (UN|T Cover)	
Vitalic	Vitalic ‚Ä¢ Second Lives	
Vitalic	Vitalic - Rave Kids Go	
–ö–∞–∫–∞—è –†–∞–∑–Ω–∏—Ü–∞	–†–∞—Å—Å–≤–µ—Ç	
–≠–ª–¥–∂–µ–π	911	
THORSUN	Styles of Beyond - Nine Thou (Slowed Perfectly)	
–≠–ª–¥–∂–µ–π	Wunder King	
nachohendrix	Wake Up - Rage Against The Machine (Guitar Cover)	
–í–∞–¥–∏–º041	Sobakka (–∞–∫–∞. –û–ª–µ–≥ –ë—Ä–æ–≤–∞—Ä—Å–∫–æ–π) - –ë–µ–ª—å–µ EP	
VAPIRA	Murderer	
moonvampire	Suicide	
Dronarivm	The Green Kingdom - Untitled (from 'Expanses' CD)	
KinoCoj	–ü–æ—Å–ª–µ–¥–Ω–∏–π –≥–µ—Ä–æ–π	
KinoCoj	–ú–µ—Å—Ç–æ –¥–ª—è —à–∞–≥–∞ –≤–ø–µ—Ä–µ–¥	
Batuhan Sen	Gouge Away	
Feunix	KaxBells - Totality	
Fun Player	the neighbourhood - the beach (instrumental, slowed & muffled )	
reidenshi, √òneheart	snowfall w/ √òneheart	
Renato Meylan	The Pixies  - Monkey Gone To Heaven (Bass)	
Two-One	HEAD HANGIN LOW Feat. DNOK	
Adam The Alien	Humming Bird	
Pity Party (Girls Club)	I hope that u think of me	
BLKSMIITH	7.SR20DET	
Kavinsky	Kavinsky - Nightcall	
lilscarl	I'M NOT THE ONE IN TROUBLE HERE	
Midnight	I'm Here - OneShot OST	
aLex!	Where is my mind (Slowed)	
Memorex Memories	Pictures Of Purple Skies	
Target Demographic	Dreaming About You	
Kade Chorusthorne (I STAND WITH UKRAINE)	Machine Girl - Virtual Paradise (Neon White OST)	
ÊÜÇÈ¨±	Sun	
skiorly	lil peep x nirvana - beamer boy (miro)	
oDDling	Aurora	
valentine	separation anxiety	
scarmaid	not needed in the real world	
Worldmuzic ‚ô¨‚ô™‚ô´	The Police - Every Breath You Take (Live in Montreal, Canada 1983)	
SUICIDAL-IDOL	ecstacy - (slowed)	
Ramshtain - Ich will	Rammstein original - Ich will	
Andrew	Lil Peep x Nirvana - Save That Shit (miro mashup)	
Lil Peep	star shopping (prod. kryptik)	
Renato Luis	Metallica - Ride The Lightning	
Jean-francois Kryl	For Whom The Bell Tolls	
Salvadoreando	Gal Costa E Nacao Zumbi - Barato Total	
üçâ HBKü™Ø	–ò—Ü—ã–∫ –¶—ã–ø–µ—Ä feat. –ò–≥–æ—Ä—å —Ü—ã–±–∞ - –î—ã–º–æ–∫.mp3	
KinoCoj	–í–æ—Å—å–º–∏–∫–ª–∞—Å–Ω–∏—Ü–∞	
KinoCoj	–ú–æ–∏ –¥—Ä—É–∑—å—è	
KinoCoj	–ú—É—Ä–∞–≤–µ–π–Ω–∏–∫	
KinoCoj	–ú–∞–º–∞ –ê–Ω–∞—Ä—Ö–∏—è	
KinoCoj	–ê–ª—é–º–∏–Ω–∏–µ–≤—ã–µ –æ–≥—É—Ä—Ü—ã	
TheZorgen	The Offspring You Are Gonna Go Far Kid	
KinoCoj	–ö–æ–≥–¥–∞ —Ç–≤–æ—è –¥–µ–≤—É—à–∫–∞ –±–æ–ª—å–Ω–∞	
Holding a Beating Heart	Deftones - Be Quiet And Drive Slowed and Reverbed	
DJ –ü–ï–†–ï–ö–†–´–¢	Kekain	
DJ –ü–ï–†–ï–ö–†–´–¢	–ú—è–∫–æ—Ç–∫–∞	
DJ –ü–ï–†–ï–ö–†–´–¢	–î–æ–º —Å –ø–æ–Ω–∏–∂–µ–Ω–Ω—ã–º –∫–∞—á–µ—Å—Ç–≤–æ–º	
DJ –ü–ï–†–ï–ö–†–´–¢	–í –ü–∏—Ç–µ—Ä–µ –∂–∏—Ç—å —Ö–æ—Ä–æ—à–æ	
DJ –ü–ï–†–ï–ö–†–´–¢	–¢–µ—Ö–Ω–æ–ª–æ–≥–∏—á–µ—Å–∫–∏–π –∏–Ω—Å—Ç–∏—ä—É—ä	
ripmyfxceoff	deftones - lucky you	
goreshit	game over.	
unkown	sidewalks and skeletons  goth (slowed+reverb)	
www://https	9mm - memphis cult sped up "watch my 9mm go bang, wa-da-da-dang, wa-da-da-da-dang"	
aidenh	The Smashing Pumpkins - 1979	
Heidi.luvs.u	1979 - ùôèùôùùôö ùôéùô¢ùôñùô®ùôùùôûùô£ùôú ùôãùô™ùô¢ùô•ùô†ùôûùô£ùô® - ùôéùô•ùôöùôô ùô™ùô•	
FXRGE	Hustlaz	
jeveuxrien	tu vis dans ma caveau	
Drughi1l	LIL KRYSTALLL - Mazzaleen	
COMEDOWNCHICK	COMEDOWNCHICK - –ë–ò–ó–ù–ï$$ 9.5 MIXTAPE	
ANNMALIBU	from da hills	
svttrzm.	—É–±–µ–π –º–µ–Ω—è, —ç–π—Å! - –Ω–∏—á–µ–≥–æ —Å–≤—è—Ç–æ–≥–æ	
Fixions	Rise of the Centaur [FREE DL]	
misakyia	–¥–æ–º –ø—Ä–µ—Å—Ç–∞—Ä–µ–ª—ã—Ö –∞—É—Ç–∏—Å—Ç–æ–≤ - —Å–∏–Ω—Ö—Ä–æ—Ñ–∞–∑–æ—Ç—Ä–æ–Ω	
tarutrit	metamorphosis (old mix)	
paragvaev	90   –ë—É–µ—Ä–∞–∫	
cut outs </3	Suisside - Dark Side Of The Moon (Cut out beginning looped + Sped up + reverb)	
sakutq	everlong - Foo Fighters // instrumental sped up	
Foo Fighters	Everlong	
Garth_Knight	Garth Knight - Neuron	
Lazerhawk	Dream Within A Dream	
Lazerhawk	Feel The Rush Tonight (feat. GUNSHIP)	
scarmaid	knife.exe	
ward wills	distance (È´™„Åå„ÇÜ„Çå„Å¶„ÅÑ„Çã)	
Eery	off-white	
Car-D Romantic	Growing Down [Free Download]	
elijah who	each other (w/ R≈ÆDE)	
WMD	Ficus [VINYL NOW AVAILABLE]	
CASSO BLVCK	SLOW JAM	
–º–æ–ª—á–∞—Ç –¥–æ–º–∞	—Ç–æ—Å–∫–∞	
Helly Helen	5 –©–µ–Ω–∫–∏ - –°—Ç—Ä–∞–Ω—ã	
–ö–≤–µ–Ω—Ç–µ–≤	–£–ª—å—Ç—Ä–∞–Ω–∞—Å–∏–ª–∏–µ	
ssshhhiiittt!	c–µ–∫–æ–Ω–¥-—Ö—ç–Ω–¥	
Helly Helen	4 –©–µ–Ω–∫–∏ - –ü–æ—Å—Ç—É–ø–∏–º –¢–∞–∫	
punkmodernisty	–¢–æ–ª—å–∫–æ –ß–µ—Å—Ç–Ω–æ	
Tvoe.daleko	–õ–µ—Å –ø–æ—Ü–µ–ª—É–µ–≤	
–∫—É–∫—É—Ä—É–∑–Ω–∏–∫	—É–ª—å—Ç—Ä–∞–Ω–∞—Å–∏–ª–∏–µ - –≤–ª–∞–∂–Ω–æ—Å—Ç—å (slowed 0,95)	
INVERTED AUDIO	AL-90 & DX2OV - Odna [Fuselab]	
1qaukeu5bxw0mj0ocosb44d4	–ú–æ—Ç–æ–≥–æ–Ω–∫–∏ - –í–µ—Ç–µ—Ä - Wind	
BUDDHA KUSH	fake cypher freestyle	
Wied≈∫min	TVETH - Provolone	
Ryder	You Are (Not) Alone W// Alparr	
roDICH	SNEG	
ùîêoon ùîáeity	Wrong Number 2	
ZODIVK	ZODIVK, Bearded Legend - The Wayfarer	
t.A.T.u. Media	Prostie Dvizheniya (–ü—Ä–æ—Å—Ç—ã–µ –î–≤–∏–∂–µ–Ω–∏—è)	
Fernando Evangelista 4	Bjork - Army Of Me	
low pulse	Kitty	
DJ –ü–ï–†–ï–ö–†–´–¢	–í–µ—Å–µ–ª–∞—è –ø—Ä–æ–≥—É–ª–∫–∞ –ø–æ–¥ —Ñ–µ–Ω–æ–º	
Minecraft Wizards	18 C418 - Sweden	
–†—É—Å—Å–∫–∞—è –†—ç–ø-–°—Ü–µ–Ω–∞	TVETH —Ö SEVNZ —Ö –õ–æ—Ä–∞ - 200	
–ú–∞–∫—Å –ö–æ—Ä–∂	–õ—É—á—à–∏–∏ÃÜ –≤–∞–∏ÃÜ–±	
–•–∞—Å–∫–∏	–ü–æ—ç–º–∞ –æ –†–æ–¥–∏–Ω–µ	
66.6	Freddie Dredd ft JEEMBO - K.O	
Senya Moro	I Really Want to Stay at Your House	
Stuck In The Sound	Stuck in the sound- Brother	
Joywave	Destruction	
dssctveself	care only about me	
golemm	Sweet Tooth	
–∞—Ä—É—Ä–∏–ø	–Ω–∞–∏–∑–Ω–∞–Ω–∫—É	
War 4ngelz255	breaking knees with baseball bats	
terra gatsuki	Simp Pilgrim	
Oo Sweetman, DJ Alan	Oo Sweetman Pres. DJ Alan - 004 (P'ella Mix)	
Melanite DJ	Make you mine	
watering	Fallen Angel	
Bomfunk Mc's	Bomfunk Mc's - Freestyler (Feel XS Remix)	
Wendy's Drive Thru	Bomfunk MC's - Freestyler (Wendy Bootleg)	
–≤–ª–∞–¥ –ø–∏–≤–æ	–£–±–∏–π—Ü–∞	
**RE-Bonjour √† Tous	–≤–µ—Ä—Ç—É—à–∫–∞ –≥–∞–∑–º–∞–Ω–æ–≤–∞ - —à–∫–æ–ª—å–Ω–∏—Ü–∞	
plenka	Closed	
–î–∞–Ω–∏–∫	plenka - Call Me (Slowed)	
plenka	nightmare (2015)	
AENEAS	murder	
eery	Reefer	
–°–ú–ù	–ë–´–°–¢–†–´–ô —Å–º–Ω	
Unfound	Without	
Loog Taylor	23072301	
isemeltss	–ü–∞—à–∞ –¢–µ—Ö–Ω–∏–∫ - –ù–∞ –Ω–∞–¥–æ	
DJ –ü–ï–†–ï–ö–†–´–¢	–¢–µ–ª–µ–≥—Ä–∞–º	
DJ –ü–ï–†–ï–ö–†–´–¢	–ì–õ–ò–¶–ò–ù	
–£–ë–ò–ô–¶–´	–£–ë–ò–ô–¶–´ - –ü–ò–ù–ì-–ü–û–ù–ì [–ù–ò–ò GULAG REMIX]	
Karbofos üî•	–í–µ—Ä—Ç—É—à–∫–∞ –ì–∞–∑–º–∞–Ω–æ–≤–∞ –î–µ–≤–æ—á–∫–∞-—Ñ–µ–º–∫–∞	
aphextwinsucks	amen break nostalgia	
–£–±–∏–π—Ü—ã	–£–ë–ò–ô–¶–´ - –ì–æ—Ä–∂—É—Å—å	
watering	Staying awake for too long	
watering	leo	
watering	happy brain	
watering	Dojacore 2	
watering	you suck at love	
watering	generic emo breakcore	
watering	playing 1.3.2 on my moms laptop without a single care for the outside world	
watering	^_^	
Paola Nadim	~Death Note Misa Theme II	
blair	valasy Àö‚úß‚Çä‚ÅénuÃàrnberg „Äêslowed & reverb„Äë	
aloo:)	Scary Gary	
ROU ROT, SADIE PINN	lost	
J$RB	Haunt - Falling In Love	
PASTEL GHOST	DARK BEACH	
Pastel Ghost	Pastel Ghost - Dark Beach (sped up)	
NANORAY	SALMON CANNON DELUXE	
–°–∞—à–∞ –∏ –ú–∞–∫–∞—Ä	–°–∞—à–∞ –∏ –ú–∞–∫–∞—Ä - FMH (v1)(–º–µ–Ω—é) / OST  –ë—É–ª–∫–∏, –∫–µ—Ñ–∏—Ä –∏ —Ä–æ–∫-–Ω-—Ä–æ–ª–ª	
Sonic Mayhem	Futureland Feat Power Glove	
raexak	gesaffelstein - aleph (slowed reverb)	
Visceral Design x anatu	Visceral Design x anatu - dream of another way out	
Drowning	Vague003 ‚Äì Drowning	
–ú–≠–ô–ë–ò –ë–≠–ô–ë–ò	–ú–≠–òÃÜ–ë–ò –ë–≠–òÃÜ–ë–ò & –ö–†–û–ö–ò ‚Äî –ë–∞–Ω–¥–∞-–ü—Ä–æ–ø–∞–≥–∞–Ω–¥–∞	
„Ç§„Ç¢ / ia	I wish to have a happy end	
dracodraco	through the light	
Second Russian Rap Scene	–≥–Ω–∏–ª–∞—è–ª–∏—Ä–∏–∫–∞ - –Ω–µ —Å–ª–µ–∑–∞–∏ÃÜ	
–§–†–ï–ù–î–ó–û–ù–ê	–ú–≠–ô–ë–ò –ë–≠–ô–ë–ò ‚Äî –ê—Å–∫–æ—Ä–±–∏–Ω–∫–∞	
reveur_ki	There she goes Ezekiel	
MegaDrive	Converter	
OBLADAET	KENNY	
Pastel Ghost, Rami Layli	Pastel Ghost - Silhouette Slowed By LX	
–ü–æ—Ä–µ–∑ –Ω–∞ –°–æ–±–∞–∫–µ	–ø–æ—Ä–µ–∑ –Ω–∞ —Å–æ–±–∞–∫–µ ‚Äî —É –ø–æ–∂–∞—Ä–∞ –≤–Ω—É—Ç—Ä–∏	
–í–∞–Ω—è ¬´armi9z¬ª –§–µ—â–µ–Ω–∫–æ	–ê–ò–ì–ï–õ - –ê—Ä–∏—è –°—É–¥—å–∏	
–ö–ª–∏–º –ë–µ–ª—É–≥–∏–Ω	The Prodigy - Smack My Bitch Up (Original Mix)	
DJ BABY CASH	BLADE	
KotE37	–ó–∞—Ç—É—Å—É–π—Å—è –ø–æ–¥ –ú–°	
Cephalothorax	–ì–æ–ª–æ–≤–æ–≥—Ä—É–¥—å - –£–≥–ª—è	
YENI	YENI - D City Rock [ We Are Angels ] ( Original Remix )	
OBORVI OKOVI	OBORVI OKOVI	
Alfa PwP	Davay Priqolimsya	
adoptahighway	Woven Hands And Torsos	
Zes	Love Will Take	
Jarrod Reque	-Olive- By Jake Chudnow [HD]	
BLXCKBUSTA	BLEED OUT	
Cheech	in search	
LVCK	Nausea	
:[	–øl3nk‚ñ≤ ‚Äì dream	
ŒîXIUS LI–òK x –Ω–æ–∂–µ–≤—ã–µ —Ä–∞–Ω–µ–Ω–∏—è	ŒîXIUS LI–òK x –Ω–æ–∂–µ–≤—ã–µ —Ä–∞–Ω–µ–Ω–∏—è - N–ùŒû–ô	
Kebab Boy	Modulogeek - Around - Hotline Miami 2	
Funny Death	Love Cassette from the Future	
vokeebok√¶ybgo lochtyblchvvaii	1932-33.(1)	
Orive	1. The Red Strings Club - The Red Strings Club | OST	
User 471171505	Clash Royale Theme - Drill Remix	
The Universal VIII	Clash Royale Game Music  Menu Theme  Game Theme	
Disasterpeace	01 - Vignette: Panacea	
Memo Boy	brian is the most beautiful	
Danilos	SALUKI Feat. ROCKET - –¢—É–ø–∏–∫ (feat. ROCKET)	
plenka	not gonna get us (vs. Tatu)	
ramazzan40	Plenka - Closed (Slowed), If you wanna win the lottery, You have to make the money to buy a ticket	
FACE	–ù–∞—à –º–µ–Ω—Ç–∞–ª–∏—Ç–µ—Ç	
FACE	–ù–∏–∫–∞–∫–æ–π –ª—é–±–≤–∏	
Junkie Jungle	Death Talk (Nonsens)	
Zielos≈Çaw Cover	Skillet-Monster(Cover)	
KSLV	Chase	
corn wave	soviet encounter problem	
Indecorum	Falkor's Return	
mock	Heaven Knows I'm Miserable Now	
Blood Estate	decay	
Wh0r3agamiz	plastic yard	
William Woodhouse	mistake	
ÔΩå ÔΩÖ ÔΩò ÔΩï ÔΩì Ôº∑ Ôº© Ôº∞	i dont think i can do this again but i destroyed it (early wip xd)	
JT	Spill It On The Ground	
Rew	You Cant Hate Me Anymore	
Rew	If It's Never Right	
Triskelis	–ì–¥–µ –§–∞–Ω—Ç–æ–º - –≠—Ç–æ —Ç–∞–∫ –∞—Ä—Ö–∞–∏—á–Ω–æ	
–ú–´	–û—Å—Ç—Ä–æ–≤	
acjazz	–ö–∏–Ω–æ. –î–µ—Ä–µ–≤–æ	
–º–æ–ª—á–∞—Ç –¥–æ–º–∞	–ø—Ä–æ–≥–Ω–æ–∑	
nPocTo_DyHyJl	–ì–¥–µ –§–∞–Ω—Ç–æ–º? - –Ø –¢–µ–±—è –õ—é–±–ª—é	
–∂–∞–≤–æ—Ä–æ–Ω–æ–∫ –∫–∏—à–æ–∫	–ì–¥–µ –§–∞–Ω—Ç–æ–º? - –°—Ç–∞—Ä–∏–∫	
–ö–æ—Å–º–æ—Å –Ω–∞ –ø–æ—Ç–æ–ª–∫–µ	–í–µ—á–µ—Ä–∏–Ω–∫–∞	
–ö–æ—Å–º–æ—Å –Ω–∞ –ø–æ—Ç–æ–ª–∫–µ	–ë–∞–ª–∫–æ–Ω	
–¶–∏—Ä—Ä–æ–∑ –ü–µ–Ω—Å–∏–∏	–Ω–æ–º–µ—Ä 5	
No Man's Land	No Man's Land - –°–º–µ—ë—Ç—Å—è	
they are gutting a body of water	houseplant	
Goth Hippie	GOTH HIPPIE - ACID EATER	
deb never	Out of Time	
SPARK MASTER TAPE	GRNFTHR (Produced by Paper Platoon)	
Sink Saiko	Stacey	
Ko√ßitSkoria / Orqzeu	Ko√ßitSkoria - chess	
Sorry about my face	Her best friend	
usedcvnt	Inhuman (w/ aak3)	
/SXGXVX.	CRIMINAL	
Sorry about my face	everyone remembers	
Sorry about my face	dsa	
Aza.	I Felt You -xxtarlit	
kkkar78	Wpcwe - —Ä–∞—Å—Å–∫–∞–∂–∏ –º–Ω–µ 134	
glitchtrode	Sadness - I want to be with you (glitchtrode Remix)	
BLKSMIITH	8.F R A G M E N T	
–ö–†–£–ñ–û–ö	–ü–∞–Ω–∫	
–ö–†–£–ñ–û–ö	–•–æ—Ä–æ–≤–æ–¥	
–ö–†–£–ñ–û–ö	–°–≤–∏—Å—Ç	
–ö–†–£–ñ–û–ö	–≠–º–∏–≥—Ä–∞—Ü–∏—è	
Skrillex	Skrillex, Missy Elliott & Mr. Oizo - RATATA	
M83	Intro (ft Zola Jesus)	
REPOSTMAN	Fire Shall Devour Them	
Mute Records	Apparat - Ash/Black Veil	
Papagaio El√©trico	Tempo Perdido (Legi√£o Urbana)	
Grizzly Bear	Two Weeks	
–ü–µ—Å–∞—Ä	Gone.Fludd-–ü–ª–æ—Ö–∞—è –°—É–∫–∞ (original)	
GONE.Fludd	GONE.Fludd - –í–£–î–£	
GONE.Fludd	GONE.Fludd - –ú–û–ì–£ –ü–ù–£–¢–¨ –≠–¢–û (feat. ‚ÄãI61)	
LovelySharkPlush	the only thing i had to do	
Cheech	transsibir'	
SEEMEE & MAYOT	SEEMEE & MAYOT ‚Äì WINDOWS	
Hiroshi Fujiwara	I Dance Alone	
BATO, JEEMBO, SEEMEE	BATO & JEEMBO & SEEMEE ‚Äì JUNGLE	
NumLOW	KIZARU X OG Maco - Sunny Drive	
lizzy :)	boys dont cry - sped up	
hellobabbie	dirk. - Toothpick By Hello.babbie	
i	insomniac- memo boy/chakra efendi SLOWED	
RetroJapan	Kyoto Station	
sorryyyouaredeaddd	Where Is Your Love?	
prprprpr	Memo Boy  Chakra Efendi-Insomniac	
(//)	Frail ‚Äì Crystal Castles	
Kick Puncher	Nemesis	
Speed Machine	Confrontation	
sayuw	Journey	
Paola Nadim	~Death Note Mello Theme I	
Taha Furkan √áolak	Death Note Ending 2 [Full]	
Paola Nadim	~Death Note Misa Theme I	
death note soundtrack	Deathnote|Kodoku	
wawa	UNDERTALE - Small Shock (GENOCIDE, with rain ambience, EXTENDED)	
angrysausage	Toby Fox - UNDERTALE Soundtrack - 28 Premonition	
Carpenter Brut	Escape From Midwich Valley	
Kebab Boy	Delay - Hotline Miami 2	
und3ad	Bloodline (Scattle cover)	
Fixions	Fixions - Putrid Waves	
LudoWic	LudoWic - Katana ZERO (Shore Disorder Remix)	
godXtsar	–º–æ–Ω–µ—Ç–æ—á–∫–∞ ‚Äî –ø–æ—Å–ª–µ–¥–Ω—è—è –¥–∏—Å–∫–æ—Ç–µ–∫–∞ (prod. –≤–∏—Ç—è –∏—Å–∞–µ–≤)	
sumfUll	–î–∞–π—Ç–µ —Ç–∞–Ω–∫ (!) - –õ—é–¥–∏	
M12	–ú–û–ù–ï–¢–û–ß–ö–ê ‚Äî –ü–ê–î–ê–¢–¨ –í –ì–†–Ø–ó–¨	
bilka?	Fl—ëur - –ë—É–¥—å –º–æ–∏–º —Å–º—ã—Å–ª–æ–º	
Serhii Savochkin	–í–æ—Ö–∞ –∏ –õ—ë—Ö–∞	
neurojutsu	–≠–ª–µ–∫—Ç—Ä–æ—Ñ–æ—Ä–µ–∑ feat. Superkomfort - –§–æ—Ç–æ–≥—Ä–∞—Ñ	
–≠–∫—Å–ø–µ—Ä—Ç –ø–æ —Ö–æ–ª–æ–¥–∏–ª—å–Ω–∏–∫–∞–º	–î–∞–π—Ç–µ —Ç–∞–Ω–∫ (!) - –ú—ã	
Noire Shapes	The Violent Youth - Shine	
–∫–∞—Ä—Ç–æ—à–∫–∞	–¥–∞–π—Ç–µ —Ç–∞–Ω–∫ (!) - —É—Ç—Ä–æ	
BacktoBeat	BEETLEBUM	
chelou	Halfway To Nowhere	
Lena	Íí±‡øê‚ô° Àö.*‡≥É Niteroi Basket ft. Caru Íí±‡øê‚ô° Àö.*‡≥É	
Nitin soni 10	Boulevard of Broken Dreams	
Scott Pilgrim Music	Beck - Ramona (Acoustic)	
WPCWE	WPCWE - ANOREXY	
–©–µ–Ω–∫–∏	–©–µ–Ω–∫–∏ - –£—Ö–æ–¥–∏ –µ—Å–ª–∏ —Ö–æ—á–µ—à—å	
Hensonn	Bad party	
Myles Johnson	Fkbambam (ft Hensonn)- Dark Sauce	
i61, Powerpuff Luv	C—É–ø–µ—Ä - –ú–∞–≥–∞–∑–∏–Ω	
OBLADAET	LOCO SMOCO FREESTYLE (OG PRINCE & ROCKET RMX)	
OBLADAET	MUTANT	
OBLADAET	WRONG	
_T R A S H	–ú–æ–ª—á–∞—Ç –î–æ–º–∞ - –û—Ç–≤–µ—Ç–∞ –ù–µ—Ç (slowed + Reverb)	
Akim	–î–µ—Ç–∏ –†–µ–π–≤ - –§–∞–∫–µ–ª–∞.mp3	
–î–ï–¢–ò RAVE	–ö–ì–ë (feat. SQWOZ BAB)	
Magic Sword	The Way Home	
Magic Sword	Legend Of The Keeper	
Mega Drive	NARC	
Mega Drive	NARC¬≥	
MommyPick	–ú–û–õ–ßA–¢ –î–û–ú–ê ‚Äì –ù–ï–¢ –ë–õ–Ø–¢–¨ –†–ê–ó–ì–û–íAP–ò–í–ê–Æ–¢   1.Kla$ ‚Äì –ü–æ—á–µ–º—É, –ú–æ–ª—á–∞—Ç –î–æ–º–∞ - —Å—É–¥–Ω–æ (mashup)	
k1n5_bt	–ú–æ—Ç–æ–≥–æ–Ω–∫–∏ - –õ–∏—Ö–æ–ª–µ—Å—å–µ	
NURTTEON	Sewerslvt - dissociating	
_skott.y	itkeepshappening	
sheitmah	ORION - TIME FOR CRIME	
Swardy	Down	
Boulevard Depo	NO HOOK NO HOES (feat. Yung Hurn)	
Boulevard Depo, SP4K	Autopoetry	
Boulevard Depo, SP4K	Qwerty Lang	
Boulevard Depo	–ì—Ä—è–∑—å	
–°–∞–º–æ–µ –ë–æ–ª—å—à–æ–µ –ü—Ä–æ—Å—Ç–æ–µ –ß–∏—Å–ª–æ	–°–ü–ë–ß - –ú–∞–ª–µ–Ω—å–∫–∏–µ —á–µ–ª–æ–≤–µ—á–∫–∏ 2010	
–°—Ç—Ä–∞–¥–∞–ª–µ—Ü	–°—Ç—Ä–∞–¥–∞–ª–µ—Ü - –•–æ—á—É –Ω–∞–∂—Ä–∞—Ç—å—Å—è	
Captain Ahab	Girls Gone Wild	
–î–ï–¢–ò RAVE	–ò–ù–û–ì–î–ê	
Jord	Boulevard Depo   Ocb Smoking Raw	
Cheech	Migraine	
i61, Boulevard Depo, Pharaoh, Basic Boy	8. i61 - FRESH SOFT ft.Boulevard Depo x Pharaoh x Basic Boy (Prod.by White Punk)	
Boulevard Depo	DRUG	
Awolnation	Run	
√Å√≥√•√∞√†√™	–ë—É–µ—Ä–∞–∫ - –î—Ä—É–≥	
–ò–∑–Ω–∞—Å–∏–ª–æ–≤–∞–Ω–∏–µ –ò –ö–∞–Ω–Ω–∏–±–∞–ª–∏–∑–º	–ò–∑–Ω–∞—Å–∏–ª–æ–≤–∞–Ω–∏–µ –∏ –∫–∞–Ω–∏–±–∞–ª–∏–∑–º - –¢—ã –ü—Ä–µ–∫—Ä–∞—â–∞–µ—à—å –î—ã—à–∞—Ç—å	
fifty__blessings	Mono Death -  –†–∞—Å—Å—Ç—Ä–æ–π—Å—Ç–≤–æ Joy Division	
IceHellÊ≠ª	Offset Ft. Cardi B - Clout [Instrumental]	
Benny Smiles	Hotline Miami Theme	
PERTURBATOR	Perturbator - Sexualizer (Feat. Flash Arnold)	
MegaDrive	Acid Spit	
DevolverDigital	Scattle - It's Safe Now	
DevolverDigital	Scattle - Flatline	
√Å√≥√•√∞√†√™	–£–ø–∞–ª	
Kick Puncher	The Order	
Surgeryhead	Scattle- Cursive (Surgeryhead Remix)	
EL TIGR3	Die Cosmonaut	
–ë–µ–Ω–≥–∞–ª—å—Å–∫–∏–µ –ü–æ–¥–æ–Ω–∫–∏	–ë–µ–Ω–≥–∞–ª—å—Å–∫–∏–µ –ü–æ–¥–æ–Ω–∫–∏ - –ö–∞–π—Ñ	
lmntvmtrlsm	–ë—É–µ—Ä–∞–∫ - –ö–æ–Ω–æ–∫—Ä–∞–¥ 2020	
EL TIGR3	Heist	
Power Glove	Power Core	
Felix Bondarev | RSAC	RSAC _ KAK NIKTO NIKOGDA	
–æ—Çs—Ç–∞–Ω—å	–ø–µ—Ä—Å–∏–∫–æ–≤—ã–µ —Å–∞–¥—ã	
–ö–æ–Ω–µ—Ü –≠–ª–µ–∫—Ç—Ä–æ–Ω–∏–∫–∏	–ö–æ–Ω–µ—Ü –≠–ª–µ–∫—Ç—Ä–æ–Ω–∏–∫–∏ - –ù–æ—á—å	
buerak	–ù–µ–ø–æ–Ω—è—Ç–Ω—ã–π –†—É–∫–æ–≤–æ–¥—è—â–∏–π –ò–º–ø—É–ª—å—Å	
buerak	–°–ø–æ—Ä—Ç–∏–≤–Ω—ã–µ –û—á–∫–∏	
vs4lt	Legalize Nuclear Bombs	
ŸÖÿµÿ∑ŸÅŸâ  ìÇÄ	Ice cream boy - Changing	
EYEZ HATE U	ETERNAL SZN (IG @eyezhateu)	
breakMyMind	–ì–ê–ó–û–í–ê–Ø –ï–ë–õ–Ø - –¢–†–£–ü –ö–û–°–ú–û–ù–ê–í–¢–ê –ù–ê –û–†–ë–ò–¢–ï	
Cheech	chepou	
MAGA BO	02 Xoror√¥ feat. Russo Passapusso (Uproot Andy Remix)	
PORTWAVE	PORTWAVE - WHAT WE DO	
Lebanon Hanover	lebanon hanover - gallowdance ‚ñ≥Sco‚ñ≥	
Last Gang Records	Crystal Castles - Wrath Of God	
–ü–∞—à–∞ –¢–µ—Ö–Ω–∏–∫	CP mikro kei( –ü–∞—à–∞ –¢–µ—Ö–Ω–∏–∫ prod. )	
–ü–∞—à–∞ –¢–µ—Ö–Ω–∏–∫	Fourlikooola	
RoboticWisp	Robotic Wisp - Undertale - Uwa!! So Holiday‚ô´ (Lo-Fi Remix)	
Olivier Adamczyk	Crystal Castles - Frail /Remix	
Stephanie Valdez Alrz	Comfortably Numb   Pink Floyd   The Wall	
Ate≈ü Evren	My Bloody Valentine Loveless	
13XBEATS	FEDERAL	
KUTE	MIND SPLIT	
apastopic	Kerosene - Crystal Castles (Slowed)	
Xero	ALYSS - Pyramid slowed to perfection (instrumental)	
KFC Murder Chicks	Wild AI Baby	
capturedtracks	Mac DeMarco // Ode to Viceroy	
onethousandmurder	–ø–µ—Å–Ω–∏ –¥–ª—è –≤–∑—Ä–æ—Å–ª—ã—Ö - —É–¥–∏–≤–∏—Ç–µ–ª—å–Ω–æ	
–ö–∞—Ä–æ–ª—ñ–Ω–∞ –†–æ–º–∞–Ω–æ–≤–∞	shit - –Ω–∞ –º–æ–µ–º –≤–µ–ª–æ—Å–∏–ø–µ–¥–µ	
Sapph	Ruins - PS4 Theme	
Ben Briggs, GameChops	Ben Briggs - TEM SHOP (Undertale Remix)	
angrysausage	Toby Fox - UNDERTALE Soundtrack - 24 Bonetrousle	
angrysausage	Toby Fox - UNDERTALE Soundtrack - 71 Undertale	
archdiggle	undertale temmie get money for colege	
Yvetzal	Calamity	
LookFor	–°–∞–º–æ–µ –ë–æ–ª—å—à–æ–µ –ü—Ä–æ—Å—Ç–æ–µ –ß–∏—Å–ª–æ - –ì–æ—Ä–∏–∑–æ–Ω—Ç	
collider-kun	–ê–∫–≤–∞—Ä–∏—É–º - –ò—Å–∫—É—Å—Å—Ç–≤–æ –±—ã—Ç—å —Å–º–∏—Ä–Ω—ã–º	
ùîêoon ùîáeity	daLIGHTman x MoonDeity - Do you like Tokyo ?	
Feerix	bloodthirsty	
Lazerhawk	Lazerhawk Interstellar	
fkbambam	OUT THE DOOR	
Groove Delight	Slipknot - Duality (Groove Delight Bootleg)	
–ö–∏—Å–ª–æ—Ç–∞	–°–ö–û–¢–û–ë–û–ô–ù–Ø-–¢–ê–ë–õ–ï–¢–ö–ò	
–ü–∞—à–∞ –¢–µ—Ö–Ω–∏–∫	Growling	
–í–∞–ª–µ–Ω—Ç–∏–Ω –°—Ç—Ä—ã–∫–∞–ª–æ	–ë–µ—Å–ø–æ–ª–µ–∑–Ω–æ	
–°–æ—é–∑ –ö–æ–º–ø–æ–∑–∏—Ç–æ—Ä–æ–≤	–°–æ—é–∑ –ö–æ–º–ø–æ–∑–∏—Ç–æ—Ä–æ–≤ - –í–í–°	
User 436445392	–ê–∫–≤–∞—Ä–∏—É–º - –ü–ª–æ—Å–∫–æ—Å—Ç—å	
Katya Akbarova	–ì—Ä–µ–±–µ–Ω—â–∏–∫–æ–≤, –ê–∫–≤–∞—Ä–∏—É–º - –ò–¥—É –Ω–∞ —Ç—ã	
Light cloud	–ê–∫–≤–∞—Ä–∏—É–º - –ì–æ—Ä–æ–¥ –ó–æ–ª–æ—Ç–æ–π	
Lenin	–°—Ç—Ä—ã–∫–∞–ª–æ - 92	
–í—ä–µ–±–∏ –µ–º—É, –î–æ–Ω–∞—Ç–µ–ª–ª–æ!	07 - –ë–æ–ª—Ç	
Foxxy Dekay	Minimix 2021	
dyingdiy	hurt redux	
Equinox7	Intervals	
stillborn	–ù–µ–±–æ –ù–∞–¥ –ì–æ–ª–æ–≤–æ–π - –£–±–µ–∂–∞—Ç—å	
Helly Helen	2 –©–µ–Ω–∫–∏ - –ì—Ä—è–∑—å	
lanesra	–¢–µ–ª–µ—ç–∫—Ä–∞–Ω - –¢—ã—Å—è—á–∞ –î–µ—à—ë–≤—ã—Ö –ó–∞–∂–∏–≥–∞–ª–æ–∫	
AndreyTaratukhin	GSPD M ‚Ä† MN KC–ü N ‚Ä†(–º–µ—Å—Ç–∞–º–∏ —ç–∫—Å–ø–æ–Ω–∞—Ç) - –ü–ê–ö–ï–¢–ò–ö –ö–ò–°–õ–û–¢–´	
AndreyTaratukhin	GSPD M  ‚Ä† MN  KC–ü N ‚Ä†(–º–µ—Å—Ç–∞–º–∏ —ç–∫—Å–ø–æ–Ω–∞—Ç) - –ê–ú–§–ï–¢–ê–ú–ò–ù	
–ª–∞–≤–∫–∞	GSPD - —Ç—ã –ø–æ–¥—Å–µ–ª–∞ –Ω–∞ –∏–≥—Ä—É	
dlb	–∫–∞—Ç–∫–∞	
Scott Pilgrim Music	Metric - Black Sheep	
Occams Laser	Temperance	
lovelysharkplush	one!	
2k / aidan dookie archive	DJ ROZWELL - NONE OF THIS IS REAL [MOTHLAND]	
ORAX	Broken	
7oldat	—é–Ω–æ—Å—Ç—å | speed up	
Sorry about my face	please, be quiet	
senpall	–õ–°–ü - –ù–µ –£–±–µ–∂–∞–ª	
Rise Against	Will Paquin - Satellite	
Skrillex	KILL EVERYBODY (BARE NOIZE REMIX)	
Skrillex	KILL EVERYBODY	
Andrea Marie	Operate - Peaches	
AWOLNATION	Sound Witness System	
Hot Flash Heat Wave	Hesitation	
–∫–æ–Ω–µ—Ü —Å–æ–ª–Ω–µ—á–Ω—ã—Ö –¥–Ω–µ–π	–û—Å–æ–∑–Ω–∞–Ω–∏–µ	
Caseyrisp4	Vanished- Crystal Castles	
Metric	Lost Kitten	
lolly	–°—ë—Ä—Ñ    –£–≤—É–ª–∞	
driedflower	–ü–µ—Ä–µ–º–æ—Ç–∫–∞ ‚Äì –ü–µ—Ä–≤—ã–π —Å–Ω–µ–≥	
‚Ä´‚Å¨‚Å¨Forever Forgotten	Joy Division - Disorder	
On Yun	–©–µ–Ω–∫–∏ ‚Äì ¬´–ü–æ –∫—Ä—É–≥—É¬ª (–û–Ω –Æ–Ω mix)	
Forstrim	–î–µ—Ä–µ–≤–æ –õ—É—á - 27 –°–µ–∫—É–Ω–¥	
Felix Bondarev | RSAC	–©–µ–Ω–∫–∏ - Whos Your Daddy	
42	–≥–¥–µ —Ñ–∞–Ω—Ç–æ–º? - —Å–º–æ—Ç—Ä—é –≤ –≥–ª–∞–∑–∞	
Nobody	–ë—É–µ—Ä–∞–∫ - –ë–æ–ª—å	
The KickDrums	Cigarette For Us	
derevo	–ì–¥–µ –§–∞–Ω—Ç–æ–º?  - –≠—Ç–æ –¢–∞–∫ –ê—Ä—Ö–∞–∏—á–Ω–æ	
buerak	–ë—É–µ—Ä–∞–∫ - –ö–æ—Ä–µ–Ω—å –ò–º–±–∏—Ä—è	
phonon	phonon - polyriddim	
Slowdive	Slowdive - Sleep	
N√ºrnberg	Valasy	
SadSvit	–ù–µ–±–æ	
bnhxbvt	–≥–æ—Ç–∏–∫–∞ –ø–∞–Ω–µ–ª–µ–∫ - –µ–≥–æ—Äbez x —Ñ–∏–∫—É—Å –≥–æ–≥–µ–Ω–∞	
sippi cup	–µ–≥–æ—Äbez - –î–æ-–¢–ª–∞	
–ø–æ—Ç–æ–º—É —á—Ç–æ —è –ø–∞–Ω–∫	—Ä–µ–ª–∞–∫—Å	
–ø–æ—Ç–æ–º—É —á—Ç–æ —è –ø–∞–Ω–∫	–ú—É–∑—ã–∫–∞, —á—Ç–æ–±—ã —É—Ö–∞–∂–∏–≤–∞—Ç—å –∑–∞ —Å–≤–æ–∏–º –ê–ö-47	
buerak	–ë—É–µ—Ä–∞–∫ - –ú–µ–¥–ª—è–∫	
–õ–∏–ª–æ–≤—ã–µ –¢—é–ª—å–ø–∞–Ω—ã	–õ–∏–ª–æ–≤—ã–µ —Ç—é–ª—å–ø–∞–Ω—ã - –ü–æ–∂–∞–ª—É–π—Å—Ç–∞, —Ç–æ–ª—å–∫–æ –Ω–µ –¥–æ–º–æ–π	
Nullset	into the astral plane	
Sad radio on Cassini	Sad Radio On Cassini - At Home	
ssshhhiiittt!	–¢–µ–±—è –ù–µ—Ç	
Stones Throw Records	James Pants - Strange Girl	
corn wave	summer playlist	
angel vox	–í–æ–∑–≤—Ä–∞—â–∞–∏ÃÜ—Å—è	
–µ–≥–æ—Ä –Ω–∞—Ç—Å	6. –î–µ–≤–æ—á–∫–∞ - –õ—Å–¥	
Swap Babies	Touched	
bnhxbvt	–µ–≥–æ—Äbez - –ú.–¢.–§	
ddslt	–°–≤–∏–¥–∞–Ω–∏–µ - –õ—é–±–æ–≤—å	
–£–±–∏–π—Ü—ã	–£–ë–ò–ô–¶–´ - NLB	
Kiile	Destiny	
Chris Zabriskie	I Want To Fall In Love on Snapchat	
Sidewalks and Skeletons & Brothel	Sidewalks and Skeletons & Brothel - Higher	
Sidewalks and Skeletons & Catslash	Sidewalks And Skeletons, Catslash - Vices	
–ø–æ—Ç–æ–º—É —á—Ç–æ —è –ø–∞–Ω–∫	–ö–æ—Ä–µ–Ω—å –∏–º–±–∏—Ä—è	
MIAMI NIGHTS 1984	Ocean Drive	
Yameii Online	yameii - baby my phone (prod. deko)	
pasdewe	Moderat - A New Error	
Vsevolod Maslov	–ü–∞–ø–∏–Ω –û–ª–∏–º–ø–æ—Å - –û—Ñ–∏—Ü–∏–∞–Ω—Ç–∫–∞	
koenokatetsu	—Ñ—Ä–∏–∫ –ø–∞—Ç–∏ –≤—Å–µ —á—Ç–æ —è —É–º–µ—é	
DK	–í—Å—ë –≤ –ø–æ—Ä—è–¥–∫–µ	
DK	–¢—ã –º–µ–Ω—è –Ω–µ –∏—â–∏ (feat. –í–∏—Ä—É—Å)	
maria	The Drums - I Dont Know How To Love	
dayssago	–ê–ª—ë–Ω–∞ –®–≤–µ—Ü - –æ–ª–∏–º–ø–æ—Å ¬ª	
sharoeb	–Ω–µ–∫—Å—é—à–∞ - –ê–π—Ç–∏—à–Ω–∏–∫	
klimusik	ESCAPE2021	
Sway	Rojo	
Agderius	pa$$ the time - bronze (Agderius Remix)	
ÊÑõ „Å® Ëä∏ Ë°ì	deftones - please let me get what i want (slowed+reverb)	
‚Ä¢ slowedstation ‚ù¶ ‚Ä¢	deftones ‚Ä¢ *+ be quiet and drive *+	
TanmanG	gut feeling	
cock sucker	ùîÖùî¢ ùîÆùî≤ùî¶ùî¢ùî± ùîûùî´ùî° ùî°ùîØùî¶ùî≥ùî¢.	
jman22227	Theory Of Everything	
kedr_livanskiy	winter mix.com/2016.2017	
–ú–æ–π –ë—É–º–∞–∂–Ω—ã–π –ü–∞–∫–µ—Ç	–ú–ë –ü–∞–∫–µ—Ç - –ê–ª–∏—Å–∞ –≤ –°—Ç—Ä–∞–Ω–µ	
–£–±–∏–π—Ü—ã	–î–∞–Ω–∞—è	
–£–±–∏–π—Ü—ã	–ù–æ–∂–∏–∫–∏	
–£–ë–ò–ô–¶–´ CRYSTAL	–ì—Ä–∏–≤–∞—á–∏	
Neon Vandal	Decadent Dreams: Main Titles	
:-Existentialcrisis-:	OMORI OST - 006 Let's Get Together Now!	
Bowl Of Chowda	The Beatles - Eleanor Rigby	
Fachmann	Gefradah - Cancertid	
vitasik	ooes - –ø–æ—Å–ª–µ–¥–Ω–µ–µ –ª–µ—Ç–æ	
3rtc	Subtle Sexuality - Male Prima Donna - The Office	
–ü–û–®–õ–ê–Ø –ú–û–õ–õ–ò	–î–∞–∂–µ –º–æ—è –±—ç–π–±–∏ –Ω–µ –∑–Ω–∞–µ—Ç	
FacexHugger	FacexHugger - The new batch	
-ft-	FacexHugger - Power Unleashed (Feat. Street Cleaner)	
–ü–û–®–õ–ê–Ø –ú–û–õ–õ–ò	–ö–ª–µ–æ–ø–∞—Ç—Ä–∏	
DOGLAND	So Fine & So Mine	
marcelomed22	Le Castle Vania ‚Äì Red Circle (LED Spirals & Shots Fired)	
„ÅëÔΩç SURF	Mushroom Rock	
Inner Wave	Courtside/Swang Remix	
Inner Wave	1 4 2	
BORO	PRACTICAL HEART by Bryan Aspey & Quantum Lovers	
CHELSEA WOLFE	ADVICE & VICES	
damasound	Pixies - Ana	
Dirty Heads	Stand Tall	
FELO SKURT	Horcrux	
Sun Era	Lost My Mind	
Sun Era	Kid	
r√©mi	unusual breakcore mix	
gaby	CHERRY WAVES - DEFTONES (sped up)	
SEXKILLA	SENSE	
No name No life	Yahochupikachu - —Ä–∞—à–∞—Ç—É–¥–µ–π	
Sergey Karpenko	–£–±–∏–π—Ü—ã Crystal - Home Video	
eniziz	Yahochupikachu - –ø–æ–∫–∞—é—Å—å	
Kill Bill: The Rapper	Thnkn [Feat. Rav] (Prod. miraa.)	
Volkor X	The Duel	
Vl.K	WPCWE X –ü–ê–®–ê –¢–ï–•–ù–ò–ö - –£–õ–ò–¶–ê–°–°–°–ê–õ–ê–°–¨	
Constantin Dekhnich	WPCWE x –ü–ê–®–ê –¢–ï–•–ù–ò–ö - –¢–≤–æ—è –º–∞–º–∞ –µ–±–∞–ª–∞—Å—å —Å —Ç–∞—Ç–∞—Ä–æ–º	
Duda Castro	Weezer - Say It Aint So	
M83	M83 - Outro	
webkey	WPCWE - –≠–¢–û –ù–ï –ò–°–ö–£–°–°–¢–í–û	
k–∏+a	WPCWE: –ü–æ–¥—Ä—É–∂–∫–∏-–Ω–∞—Ä–∫–æ–º–∞–Ω–∫–∏ //grechka	
Smeltepunkt	PPK - Resurection (Space Club Mix)	
Dragonette	Martin Solveig & Dragonette - Hello	
Dan Terminus	Restless Destroyer	
Dan Terminus	The Wrath Of Code (feat. Perturbator)	
HappyHourband	Buddy Holly - Weezer	
Julia & Winston	–ë–∏-2 - –ö–æ–º–ø—Ä–æ–º–∏—Å—Å	
Everything Gorillaz - P2	Feel Good Inc.	
Nelsaz	–ë–∏-2 - –ú–æ–ª–∏—Ç–≤–∞	
Everything Gorillaz - P3	Stylo	
PlatinumLights	Gorillaz - DoYaThing (Full Version)	
Dead City Blues	Archive - Bullets	
Porter Robinson	Porter Robinson & Madeon - Shelter	
Illenium & Porter Robinson	Illenium & Porter Robinson (Where'd You Go vs. Divinity)	
Nikolya Che	Kedr Livanskiy - 2MR Transmission @ The Lot Radio July 25th 2018	
kkkar78	Wpcwe - you is mine	
Miyagi & Andy Panda	Brooklyn (feat. TumaniYO)	
MC Holocaust	Undaground Enemy (DJ AKOZA EDIT)	
void_asterisk	Avril 14th	
–ü–û–®–õ–ê–Ø –ú–û–õ–õ–ò	–®–∫–æ–ª–∞ –Ω–µ –Ω—É–∂–Ω–∞	
LovelySharkPlush	hang in there	
void_asterisk	sm chilling sht	
LovelySharkPlush	ElyOtto - SUGARCRASH!! (breakcore edit)	
feonao	Crayon	
:-Existentialcrisis-:	OMORI OST - 005 By Your Side.	
Cipo	OMORI OST - 043 Finding Shapes In The Clouds	
Cipo	OMORI OST - 040 You Were Wrong. Go Back.	
Cipo	OMORI OST - 036 CHAOS ASSEMBLY	
kkkar78	wpcwe_napuganniy –Ω–∞–ø—É–≥–∞–Ω–Ω—ã–π	
FERNGAZER	Preoccupied	
LovelySharkPlush	spaces inbetween (sharky edit)	
o.d. unknown	It's Not A Choice Kid	
SEXKILLA	DOPE	
SEXKILLA	NOT OVER	
Xxtarlit‚ö∏	snowdrift	
–£–±–∏–π—Ü—ã	–ê–Ω–¥—Ä–µ–π	
alicekinski	–£–±–∏–π—Ü—ã - –ü–∏–Ω–≥-–ø–æ–Ω–≥	
Iggy Sharkov	DenDerty - –ö–∏—Å–ª–æ—Ç–∞	
–≤–µ—Ä—Ç—É—à–∫–∞ –≥–∞–∑–º–∞–Ω–æ–≤–∞	–∫–∞–∫ –ö–∏–∞–Ω—É	
—Å–Ω–∞–º–∏ —ç—Ç–æ –±—ã–ª–æ —Å –Ω–∞–º–∏	Youhate - –ú–æ–ª–æ–¥–æ–π –ò –ü—å—è–Ω—ã–π	
Iam Igor	–£–ë–ò–ô–¶–´ - –î–≤–∞ –ò–∫—Å–∞	
stefie322	J R Y X 4ERNOBURKV - Speed	
–æ—Çs—Ç–∞–Ω—å	12 —Ö—Ä–∏–∑–∞–Ω—Ç–µ–º	
mlrd	–£–ë–ò–ô–¶–´ CRYSTAL [–í–∏–∫–∞ –ß–µ—Ö–æ–≤–∞] - –ö—Ç–æ —è?	
wpcwe1	Wpcwe ‚Äì prelude 1.2	
LovelySharkPlush	Snow	
LovelySharkPlush	Cozy	
LovelySharkPlush	anything new	
LovelySharkPlush	a better way	
LovelySharkPlush	i got my soul back	
LovelySharkPlush	it was nice to talk to you again	
LovelySharkPlush	can we be friends?	
LovelySharkPlush	think of something nice	
LovelySharkPlush	home alone	
LovelySharkPlush	lonely	
LovelySharkPlush	Track no. 20	
LovelySharkPlush	things that never happened [lofi hiphop]	
LovelySharkPlush	moving on [lofi hip hop]	
LovelySharkPlush	i cant do anything about it [lofi hip hop]	
LovelySharkPlush	you know me	
maxzeroth_01	Maxzeroth-technoblock(c–ø—ñ–π–º–∞–π –∫–∞—Ä–∞—Å—è)	
kkkar78	wpcwe - whats is not (original)	
wpcwe1	wpcwe_'olkyghfdsfgchkjl;' ‚Äì kenrb;so	
LovelySharkPlush	Tonight	